NO ./imgs/N.xpm
WE ./imgs/W.xpm
EA ./imgs/E.xpm
SO ./imgs/S.xpm

C 255,255,0
F 255,255,255

1111111111111111111111111
1000000000110000000000001
1011000001110000000000001
1001000000000000000000001
1011000001110000000000001
1011000001110000000000001
1011000001110000000000001
10110000011100000N0000001
1011000001110000000000001
1011000001110000000000001
1111111111111111111111111
