NO ./imgs/N_yellow.xpm
WE ./imgs/W_red.xpm
EA ./imgs/E_green.xpm
SO ./imgs/S_blue.xpm

C 155,0,0
F 0,155,0

1111111111111111111111111
1000000000000000000000001
1000000000000000000000001
1000000000000000000000001
1000000000000000000000001
1000000000000000000000001
1000000000000000000000001
1000000000000000000000001
1000000000000000000000001
1000000000000000000000001
1000000000000000000000001
1000000000000000000000001
1000000000000000000000001
1000000000000000000000001
1000000000000000000000001
1000000000000000000000001
1000000000000000000000001
1000000001000000000000001
1000000100000100000000001
1000001000000000000000001
100000000000100000000W001
1000000000000000000000011
1000000000000010000000001
1000000000000000000000001
1000000000000000000000001
1111111111111111111111111
