NO ./imgs/TECH_0E.xpm
WE ./imgs/TECH_0F.xpm
EA ./imgs/TECH_0G.xpm
SO ./imgs/TECH_0D.xpm

C 0,0,51

F 51,51,50

1111111111111111111111111
1001100000000000000000001
10N0100000000000000000001
1000100000000000000000001
1111100000000000000000001
1000000000000000000000001
1000000000000000000000001
1000000000000000000000001
1000000001000000000000001
1000000100000100000000001
1000001000000000000000001
1000000000001000000000001
1000000000000000000000011
1000000000000010000000001
1000000000000000000000001
1000000000000000000000001
1111111111111111111111111
