NO ./imgs/TECH_0E.xpm
WE ./imgs/TECH_0F.xpm
EA ./imgs/TECH_0G.xpm
SO ./imgs/TECH_0D.xpm

C 0,0,51

F 51,51,50


        1111111111111111111111111
        10000000010C0000000000001
        1011000001110000000000001
        1001000000000000000000001
111111111011000001110000000000001
100000000011000001110111001C11111
11110111111111011100000000101
11110111111111011101010001001
11000000110101011100000010001
1000000000000000110000001C111
10000000000000001101010010XK1
1100000111010101111101111000111
11110111 1110101 10111101N0011
11111111 1111111 111111111111
