NO ./imgs/TECH_0E.xpm
WE ./imgs/TECH_0F.xpm
EA ./imgs/TECH_0G.xpm
SO ./imgs/TECH_0D.xpm

C 0,0,51

F 51,51,50


        1111111111111111111111111
        10000000010C0000000000001
        1011000001110000000000001
        1001000000000K000K000K001
111111111011000001110000000000001
100000000011000001110111001C11111
111101111111110111000000001K1
111101111111110111010100000K1
11000000110101011100000010001
10000000000000001100000010001
10000000000000001101010010001
110000011101010111110111100X11
11110111 1110101 1011110000N11
11111111 1111111 111111111111
