NO ./imgs/TECH_0E.xpm
WE ./imgs/TECH_0F.xpm
EA ./imgs/TECH_0G.xpm
SO ./imgs/TECH_0D.xpm

C 0,0 , 51

F 51,51,50


        1111111111111111111111111
        10000000010C0000000000001
        1011000001110000000000001
        1001000000000K000K000K001
111111111011000001110000000000001
100000000011000001110111001C11111
11110111111111011100000001101
11110111111111011101010000001
11000000110101011100000010001
100000000000000011000000111C1
10000000000000001101010010001
110000011101010111110111100X11
11110111 1110101 1011110000N11
11111111 1111111 111111111111
