NO ./imgs/TECH_0E.xpm
WE ./imgs/TECH_0F.xpm
EA ./imgs/TECH_0G.xpm
SO ./imgs/TECH_0D.xpm

C 0,0,51

F 51,51,50


        1111111111111111111111111
        10000000001C0000000000001
        1011000001110000000000001
        1001000000000000000000001
111111111011000001110000000000001
10000000001100000111011111C111111
11110111111111011100000010001
11110111111111011101010010K01
11000000110101011100000010001
1000000000000000110000001C111
10000000000000001101010010001
11000001110101011111011110N0111
11110111 1110101 1011110100011
11111111 1111111 111111111111
